백년의 고독 - 가브리엘 가르시아 마르케스 - 판타지
데미안 - 헤르만 헤세 - 판타지
모모 - 미하엘 엔데  - 판타지 
반지의 제왕 - J.R.R. 톨킨 - 판타지
네버엔딩 스토리 - 미하엘 엔데 - 판타지
어둠의 왼손 - 어슐러 K. 르권 - 판타지
미드나잇 라이브러리 - 메트 헤이그 - 판타지
도둑 신부 - 마거릿 애트우드 - 판타지
1984 - 조지 오웰 - 미스터리
호밀밭의 파수꾼 - 제롬 데이비드 샐린저 - 미스터리
노르웨이의 숲 - 무라카미 하루키 - 미스터리
인간 실격 - 다자이 오사무 - 미스터리
설록 홈즈 시리즈 - 아서 코난 도일 - 미스터리
천국의 열쇠 - 아치볼드 조지프 크로닌 - 미스터리
동물농장 - 조지 오웰 - 미스터리
검은 집 - 스티븐 킹, 피터 스트라우브 - 미스터리
위대한 개츠비 - F. 스콧 피츠제럴드 - 로맨스
달과 6펜스 - 서머셋 모옴 - 로맨스
바람과 함께 사라지다 - 마거릿 미첼 - 로맨스
노트북 - 니컬러스 스파크스 - 로맨스
연애 소설 읽는 노인 - 루이스 세풀베다 - 로맨스
키다리 아저씨 - 진 웹스터 - 로맨스
톨스토이의 사랑 이야기 - 레프 톨스토이 - 로맨스
페르세폴리스의 연인들 - 마르잔 사트라피 - 로맨스
프라이드와 편견 - 제인 오스틴 - 로맨스
로복 시리즈-아이작 아시모프 - SF
듄 - 프랭크 허버트 - SF
삼체-류츠신 - SF
멋진 신세계 - 올더스 헉슬리 - SF
아이, 로봇 - 아이작 아시모프 - SF
화성 연대기 - 레이 브래드버리 - SF
클라우드 아틀라스 - 데이비드 미첼 - SF
스노우 크래시 - 닐 스티븐슨 - SF
아침의 재발견 - 할 엘로드 - 자기개발
성공하는 사람들의 7가지 습관 - 스티븐 코비 - 자기개발
부자 아빠 가난한 아빠 - 로버트 기요사키 - 자기개발
멘탈의 연금술 - 데이비드 고긴스 - 자기개발
나는 생각이 너무 많아 - 크리스텔 프티콜랭 - 자기개발
나를 찾아가는 여행 - 헬렌 켈러 - 자기개발
나는 왜 너를 사랑하는가 - 알랭 드 보통 - 자기개발
미라클 모닝 - 할 엘로드 - 자기개발
총, 균, 쇠 - 제레드 다이아몬드 - 역사
유럽사 산책 - 노먼 데이비스 - 역사
역사란 무엇인가 - 에드워드 카 -역사
대중의 반란 - 오르테가 이 가세트 - 역사
우리는 왜 화를 내는가 - 폴 에크먼 - 역사
나는 내가 죽었다고 생각했습니다 - 질 볼티 테일러 - 역사
사피엔스 - 유발 하라리 - 역사
신곡 - 단테 알리기에리 - 역사
페르시아 전쟁사 - 헤로도토스 - 역사
