everything i wanted - Billie Eilish - 앰비언트
Fix You - Coldplay - 어쿠스틱, 발라드
옛사랑 - 이문세 - 발라드
야생화 - 박효신 - 발라드
Someone Like You - Adele - 발라드
Moves Like Jagger - Maroon 5 - 어쿠스틱
삐삐 - 아이유 - 로파이
Gravity - John Mayer - 어쿠스틱, 재즈
The Lazy Song - Bruno Mars - 어쿠스틱
Banana Pancakes - Jack Johnson - 어쿠스틱, 재즈
양화대교 - 자이언티 - 재즈, 로파이
비도 오고 그래서 - 헤이즈 - 재즈
The Show Must Go On - Queen - 클래식(어두움), 영화OST
Rolling in the Deep - Adele - 발라드
Bad Romance - Lady Gaga - 발라드
My Way - 이수 - 발라드
Perfect - Ed Sheeran - 발라드, 어쿠스틱
금요일에 만나요 - 아이유 - 어쿠스틱, 로파이
I'm Yours - Jason Mraz - 어쿠스틱
200% - AKMU - 인디, 어쿠스틱
Love Me Like That - 샘김 - 재즈, 어쿠스틱
Summertime Sadness - Lana Del Rey - 앰비언트
Square (2017) - 백예린 -로파이, 어쿠스틱
Intro - The xx - 앰비언트
기다린만큼, 더 - 검정치마 - 인디, 발라드
Royals - Lorde - 인디
hapsody in Blue - George Gershwin - 클래식(밝음), 재즈
La Creation du Monde - Darius Milhaud - 클래식(밝음), 재즈
Road to Joy - Bright Eyes - 클래식(밝음), 인디
All of Me Wants All of You - Sufjan Stevens - 클래식(밝음), 발라드
Arabesque No.1 - 드뷔시 - 클래식(밝음)
Spring - 비발디 - 클래식(밝음)
Brandenburg Concerto No.3 - 바흐 - 클래식(밝음)
Gymnopedies No.1 - 에릭 사티 - 클래식(밝음)
Hidden Orchestra - unknown - 클래식(어두움),재즈
Saman - Olafur Arnalds - 어쿠스틱
Flight from the City - 요한 요한손 - 어쿠스틱
On the Nature of Daylight - Max Richter - 클래식(어두움)
Symphony No.1 - 구스타피 밀러 - 클래식(어두움)
Goldberg Vartiation No.25 - 바흐 - 클래식(어두움)
Dream - 드뷔시 - 클래식(어두움)
Ho Hey - The Lumineers - 어쿠스틱, 인디
Old Friends - PineGrove - 어쿠스틱, 인디
Plum - Widowspeak - 어쿠스틱, 인디
Motion Sickness - Phoebe Bridgers - 어쿠스틱, 인디
Im Rauch - Bohren & Der Club of Gore - 앰비언트, 재즈
Miles To Midnight - Atrium Carceri - 앰비언트, 재즈
Rest Your Head - Somewhere Off Jazz Street - 앰비언트, 재즈
Reborn - Colin Stetson - 앰비언트, 클래식
Meer der Ruhe - Apoptose - 앰비언트
Into Greater Frequency - Torus Dome - 앰비언트
Carrying You - 천공의 섬 라퓨타 - 영화OST
Main Titles - 신비한 동물 사전 - 영화OST
완벽한 하루 - 이상순 - 발라드, 어쿠스틱
무드 인디고 - 치즈 - 발라드, 재즈
Blue in Green - Miles Davis - 발라드, 재즈
Mars - 도경수 - 발라드, 어쿠스틱
Northern Wind - City and Colour - 발라드, 어쿠스틱
My One and Only Love - John Coltrane & Johnny Hartman - 발라드, 재즈
Lullaby - Nymano - 로파이, 재즈
snowfall - idealism - 로파이, 재즈
Midnight Summer - unknown - 로파이, 어쿠스틱
affection - Jinsang - 로파이
Summer Rain - Kupla - 로파이
Soulful - L'indecis - 로파이
Blue - Saito - 로파이
In A Drawer - Band Of Horses - 재즈
You’re Everything - Pat Metheny - 재즈
I Ain't Worried - OneRepublic - 인디, 영화OST
하얀 나비 - 심은경 - 인디, 영화OST
Dragonball Durag - Thundercat - 인디, 재즈
everything - 검정 치마 - 인디
seasons - wave to earth - 인디
그대 작은 나의 세상이 되어 - 카더가든 - 인디
31 - 카더가든 - 인디